NO ./textures/Material-LIB/BrickWall/BrickWall[Red]-B.png
SO ./textures/Material-LIB/BrickWall/BrickWall[Grey]-B.png
WE ./textures/Material-LIB/BrickWall[Damaged]/BrickWall[Damaged]-B.png
EA ./textures/Material-LIB/BrickWall/BrickWall[Orange]-B.png
F 220,100,0
C 225,30,0
  111
  1001
11001
100E01
11111 