NO ./textures/Material-LIB/BrickWall/BrickWall[Red]-B.png
SO ./textures/Material-LIB/BrickWall/BrickWall[Grey]-B.png
WE ./textures/Material-LIB/BrickWall[Damaged]/BrickWall[Damaged]-B.png
EA ./textures/Material-LIB/BrickWall/BrickWall[Orange]-B.png

F 220,100,0
C 225,30,0

11111111111
1S000000001
1000   0001
10000000001
11111111111
