NO ./textures/Material-LIB/BrickWall/BrickWall[Red]-B.png
SO ./textures/Material-LIB/BrickWall/BrickWall[Grey]-B.png
WE ./textures/Material-LIB/BrickWall[Damaged]/BrickWall[Damaged]-B.png
EA ./textures/Material-LIB/BrickWall/BrickWall[Orange]-B.png
F 50,70,10
C 100,200,250

11111111111111111111111111111
11111111101100000111011111111
10000000001100000111011111111
11110111111111011100000010001
11110111111111011101010010001
11000000110101011100000010001
10000000000000001100000010001
10000000000000001101010010001
11000001110101011111011110001
11110111111101011101111010W01
11111111111111111111111111111
