NO ./path_to_the_north_texture
SO ./path_to_the_south_texture
WE ./path_to_the_west_texture
EA ./path_to_the_east_texture

F 50,70,10
C 100,200,250

  111111111
  100000001
11100001111
100E0001
11111111